rows=10
columns=16
; comment
title=This is a test level.
password=test
;
begin
################
#              #
#              #
#              #
; comment
#              #
#              #
##########     #
#              #
#              #
; comment
################
end
