rows=10
columns=20
; comment
title=This is a test level.
password=test
;
begin
####################
#                  #
#                  #
#                  #
#                  #
##########  ##     #
#        #^^#      #
#        ####      #
#                  #
####################
end
